IIIIIIIIIIIIIIIIIIIIIIIIIIIIIIIIIIIIIIIIIIIII
I...|......III....I.......I|||||II....I......
IIII|IIIII.II|BIIRIBIIIII.I|...|||...RI....RI
I..IR....I.I||BIIR.BI.....I|......IIIRI...BRI
I...RIIIBI.I||.IIRIBI.............I..RI..RB.I
II......BI.I|IIII.I.IIIIIIIIIIIIIII..RI.BR..I
I|..B..RBI.I|.....................I...|RB...I
I|IIBIIR.I.I|IIIIIIIIIIIIIIIIIIIIII...|R....I
I.PI.....I.................I................I
IIIIIIIIIIIIIIIIIIIIIIIIIIIIIIIIIIIIIIIIIIIII