IIIIIIIIIIIIIIIIIIIIIIIIIIIIIIIIIIIIIIIIIIIII
I|SSSSSSSSSS............CCC.....CCCCCCCCCCCCI
I|RRRRRRRRRR...........CRBc....CBIIIIIIIIIICI
I|RRRRRRRRRR..........CBRBc...CRB..........CI
I|RRRRRRRRRR.........CRB.Bc..CBR...........CI
I|CCCCCCCCCCCCCCCCC.CBR..BcCCRB............CI
I|BBBBBBBBBBIIIIIIcCRB...BIIBR.............CI
I|BBBBBBBBBB......cBR.......B..............CI
IPSSSSSSSSSSCCCCCCcB.......................DI
IIIIIIIIIIIIIIIIIIIIIIIIIIIIIIIIIIIIIIIIIIIII