IIIIIIIIIIIIIIIIIIIIIIIIIIIIIIIIIIIIIIIIIIIII
I.....|..|..................................I
I.....|II|..................................I
I..|.BI|I|..................................I
I|.|IBI|I|..................................I
I|IIIBI|I|....|...........|.................I
I|III.I|.IRIII|IIIIIIIIIII|.......|.........I
I|III.I||.RIII|IIRRRRRRRRR|.......|IIIIIIII.I
IpIIIIII|.....|IIBBBBBBBBB|IIIIIIIIIBRBRBRIDI
IIIIIIIIIIIIIIIIIIIIIIIIIIIIIIIIIIIIIIIIIIIII