IIIIIIIIIIIIIIIIIIIIIIIIIIIIIIIIIIIIIIIIIIIII
I...........................................I
I...........................................I
I...........................................I
I...........................................I
I...........................................I
I...........................................I
I...........................................I
IP.........................................DI
IIIIIIIIIIIIIIIIIIIIIIIIIIIIIIIIIIIIIIIIIIIII