IIIIIIIIIIIIIIIIIIIIIIIIIIIIIIIIIIIIIIIIIIIII
I...........................................I
I...........................................I
I...........................................I
I...........................................I
I...........................................I
I...........................................I
I...........................................I
IP..........................................I
IIIIIIIIIIIIIIIIIIIIIIIIIIIIIIIIIIIIIIIIIIIII