IIIIIIIIIIIIIIIIIIIIIIIIIIIIIIIIIIIIIIIIIIIII
I.......||||....R..I|......||||.....B.......I
IP......|..|....R.CI|......|..|.....B......CI
IIIIIIIII..IIIIIRIII|IIIIIII..IIIIIIBIIIIIIII
I...R............B.I|I.........|||...|||....I
I...R...........SBCI|I.........|.|...|.|...CI
I..IRIIIIIIIIIIIIBII|IISIIIIIIIISIIIIISIIIIII
I...................|IIII......III...III....I
IC..S...............|I......................I
IIIIIIIIIIIIIIIIIIIIIIIIIIIIIIIIIIIIIIIIIIIII