IIIIIIIIIIIIIIIIIIIIIIIIIIIIIIIIIIIIIIIIIIIIIIIIIIIIIIIIIIIIIIIIIIIIIIIIIIIIIIIIIIIIIIIIIII
I.......I|||.............I.B...B..B.B..B.B.......B..B.B..B.B..B.B...B..B...B....B...B..B..I
I.......I|...............I.B...BRRB.BRRB.B..R....B..B.BRBB.BRRB.BRR.BRRB...BRR..BRR.BRRB..I
I....RR.I|.......BBRIBIIII.B...B..B.B..B.B.R.....B..B.B.BB.B..B.B...B.B....B..R.B...B..B..I
I....RR.I|.....|.BBRIB...I.B.............BR...........B..B.B....BR..BRBR...BRR..BR..B.....I
I|BIIRR.I|...|||IBBRIB...I.................R.....R..R.........................R...........I
I|BI....I|......I.....II.I.RRR..RR...RR..R..R.....RR..R..R.RRR..RRR.R..R...RRR..RRR.RRR...I
I|.I....I|......I........I................................................................I
IP.I............I.........................................................................I
IIIIIIIIIIIIIIIIIIIIIIIIIIIIIIIIIIIIIIIIIIIIIIIIIIIIIIIIIIIIIIIIIIIIIIIIIIIIIIIIIIIIIIIIIII