IIIIIIIIIIIIIIIIIIIIIIIIIIIIIIIIIIIIIIIIIIIII
IIIIIIcCBccc....cCCCCCCCC.................I.I
IIIIIIcIB.II....cIIIIIIIC.................I.I
IIIIIIcIBSSI.cCcCSSSSSSIC................cD.I
IIIIIIcIBIII.II|ISSSSSSIC................cI.I
IIIIIIcISIIIIII|ISSSSSSIC................cI.I
IIIIIIcIII....I|ISSSSSSIcCcCcCcCcCcCcCcCcCI.I
IIIIIIcIII....I|ISSSSSSI.I.I.I.I.I.I.I.I.II.I
IPCCCCCSSSSSSSSSISSSSSSISISISISISISISISISII.I
IIIIIIIIIIIIIIIIIIIIIIIIIIIIIIIIIIIIIIIIIIIII