IIIIIIIIIIIIIIIIIIIIIIIIIIIIIIIIIIIIIIIIIIIII
I..||||....||||II.BBBBBBBBBBBBBBBBBBBBBBBBB|I
I..|.......|....I.BBBBBBBBBBBBBBBBBBBBBBBBB|I
I..|....|..|..|..BBBBBBBBBBBBBBBBBBBBBBBBBB|I
I..|.....BI|...I.BBBBBBBBBBBBBBBBBBBBBBBBBB|I
I........B.....I.BBBBBBBBBBBBBBBBBBBBBBBBBB|I
I|BI.....B.....I.BBBBBBBBBBBBBBBBBBBBBBBBBB|I
I|BI....I..III.I.BBBBBBBBBBBBBBBBBBBBBBBBBB|I
IP.IIIIIIIIIIIII............................I
IIIIIIIIIIIIIIIIIIIIIIIIIIIIIIIIIIIIIIIIIIIII
