IIIIIIIIIIIIIIIIIIIII
IP..B.....I.....B.B.I
IIIIBIIIIRI.....BRB.I
I...B....RI.....BRB.I
I.....IIIRI..RIIBR..I
I.IIII....I..RI.....I
IG....RII...YRI.....I
IGIIIIR.IIIIY.I...III
I.......I...........I
IIIIIIIIIIIIIIIIIIIII