IIIIIIIIIIIIIIIIIIIIIIIIIIIIIIIIIIIIIIIIIIIII
I..................|..IIIIIIIIIIIIIIIIIIIIIII
I..................|I..|..IIIIIIIIIIIIIIIIIII
I.......B.R.......I|I...I...III|............I
I|.|....B.R|.......|IRBI.II..I|.IIIIIIIIIII.I
I|I.IIIIBIR.IIIIIII.IRBI.I.I.|.I.IIIIIIIIII.I
I|ISSSSIB.R.....IBI.IRBI.I..I.I..IIIIIIIIII.I
I|ISSSSI........IBI.III.I....I...IIIIIIIIII.I
IPSSSSSI....IIIII................IIIIIIIIIIDI
IIIIIIIIIIIIIIIIIIIIIIIIIIIIIIIIIIIIIIIIIIIII